16 16
################
#......#.......#
#.......#......#
####...#....#..#
#...#......#...#
#....#....#....#
#.....#..#....##
#............#D#
#............#.#
#.....#..#.....#
#....#....#....#
#...#......#...#
#..#........#..#
#..............#
#..............#
################
1 1
9
14 8 255 255 0 1
14 9 255 0 0 1
3 10 255 255 0 -1
4 10 0 255 0 1
11 10 0 255 0 1
2 2 0 255 0 -1
4 2 0 255 0 1
5 2 0 255 0 -1
6 2 255 0 0 -1
