32 32
################################
#..#.#..........#....##...#..###
#....................#..#....###
##.#.#.#........#......#...#...#
#.......#.......###.##...##..#.#
##.#.#.#........###........#...#
#...............##....#........#
#..#.#..........####..#......#.#
#...#...##.#####################
#.......#..#..#....#...#.......#
#.......#..#....##.#...#.###.#.#
#.......#.....##....#..#...#...#
#.......#...#..#.#.....#.#.#.#.#
#.......#####.#.....#..#.......#
#.......#........#.#...#.#.#.#.#
#.......#...#..........#...#...#
#.......################.#...#.#
#.......#........#.....#.......#
#.......#..#..#....#.#.#.#.#.#.#
#.......#...#.........##...#.#.#
#.......#....#.#.#..#..#...#...#
#.......#.........#...##.......#
#.......#.......#...#..#..#.#..#
#.......#.....#........#.......#
#.......##.##################.##
#..............................#
#..#.#.........................#
#...D..........................#
#..#.#.........................#
#..............................#
#..............................#
################################
4 4
64
4 3 255 0 0 8
4 5 0 255 0 8
3 4 255 0 255 8
5 4 0 255 255 8
16 2 255 0 0 -8
10 8 0 255 255 -8
10 24 0 255 0 -8
29 24 255 0 255 -8
3 27 255 255 0 -3
4 26 255 255 0 -3
5 27 255 255 0 -3
4 28 255 255 0 -3
27 13 255 255 0 1
26 13 255 0 0 1
28 13 255 0 0 1
24 13 255 0 255 1
30 13 0 255 255 1
24 12 255 0 0 -1
24 11 255 0 255 1
24 10 255 0 0 -1
24 9 255 0 255 1
30 12 255 0 0 -1
30 11 255 0 255 1
30 10 255 0 0 -1
30 9 255 0 255 1
29 20 255 0 255 -1
29 22 255 0 0 1
29 21 255 0 255 -1
25 22 255 0 255 -1
18 2 0 255 0 1
19 2 0 255 0 -1
19 4 0 255 0 -1
19 5 0 0 255 1
20 6 255 0 255 1
26 2 255 255 0 1
27 2 255 0 0 -4
22 3 255 0 0 1
24 6 255 0 0 1
25 5 255 0 0 1
30 4 255 0 0 1
10 10 0 0 255 1
10 11 0 0 255 -1
11 11 0 0 255 1
21 22 0 255 0 -4
10 14 255 255 0 1
12 14 255 0 255 -1
13 11 0 255 255 1
21 13 0 255 255 -1
21 12 0 255 255 1
21 11 0 255 255 -1
21 10 0 255 255 3
21 14 0 255 255 3
17 13 255 0 0 -5
17 11 255 0 0 -5
18 12 255 0 0 16
16 9 255 0 0 5
10 22 255 0 0 -1
10 21 255 0 0 1
20 18 255 255 0 1
17 21 255 0 0 -1
16 21 0 0 255 -1
19 19 0 255 0 8
12 17 0 255 0 -8
14 20 0 255 0 -4
