5 5
#####
##.##
#..D#
#..##
#####
1 2
1 2 2 255 255 0 1
