16 16
################
#..............#
#..............#
#..............#
#.##############
#..............#
#..............#
#..............#
#..............#
#..............#
#..............#
#..............#
#..............#
#..............#
#.............D#
################
1 1
2
14 2 0 255 255 3
11 1 0 255 255 -3
