16 16
################
#....#.........#
#......#.......#
#....#.........#
#...##.........#
##.##..........#
#..............#
#.#............#
#..............#
#..............#
#..............#
#..............#
#..............#
#..............#
#..............#
################
1 1
7
3 3 0 0 255 1
3 2 255 0 0 1
2 2 255 255 0 1
2 3 0 255 255 1
2 6 255 255 0 -1
6 2 255 255 0 -1
5 7 255 0 0 210
